{
  "__maps__":true,
  "tilesize": [32, 32],
  "data": [
    {
      "__map__": "Test map 1",
      "res": [45, 30],
      "background": "Texture/Background.png",
      "map data": [
        ["T", "T", "A", "H", "H", "H", "H", "H", "H", "H", "H", "H", "H", "H", "H", "H", "H", "H", "H", "H", "H", "H", "H", "H", "H", "H", "H", "H", "H", "H", "H", "H", "H", "H", "H", "H", "H", "H", "H", "H", "H", "H", "H", "H", "H"],
        ["T", "A", "A", "A", "H", "A", "A", "A", "H", "H", "H", "H", "H", "H", "H", "H", "H", "H", "H", "H", "H", "H", "H", "H", "H", "H", "H", "H", "H", "H", "H", "H", "H", "H", "H", "H", "H", "H", "H", "H", "H", "H", "H", "H", "H"],
        ["T", "H", "A", "H", "A", "A", "A", "H", "H", "H", "H", "H", "H", "H", "H", "H", "H", "H", "H", "H", "H", "H", "H", "H", "H", "H", "H", "H", "H", "H", "H", "H", "H", "H", "H", "H", "H", "H", "H", "H", "H", "H", "H", "H", "H"],
        ["T", "A", "H", "H", "A", "H", "A", "H", "H", "H", "H", "H", "H", "H", "H", "H", "H", "H", "H", "H", "H", "H", "H", "H", "H", "H", "H", "H", "H", "H", "H", "H", "H", "H", "H", "H", "H", "H", "H", "H", "H", "H", "H", "H", "H"],
        ["T", "A", "A", "A", "H", "H", "H", "H", "H", "H", "H", "H", "H", "H", "H", "H", "H", "H", "H", "H", "H", "H", "H", "H", "H", "H", "H", "H", "H", "H", "H", "H", "H", "H", "H", "H", "H", "H", "H", "H", "H", "H", "H", "H", "H"],
        ["T", "T", "A", "H", "A", "A", "H", "H", "H", "H", "H", "H", "H", "H", "H", "H", "H", "H", "H", "H", "H", "H", "H", "H", "H", "H", "H", "H", "H", "H", "H", "H", "H", "H", "H", "H", "H", "H", "H", "H", "H", "H", "H", "H", "H"],
        ["H", "T", "H", "A", "H", "H", "H", "H", "H", "H", "H", "H", "H", "H", "H", "H", "H", "H", "H", "H", "H", "H", "H", "H", "H", "H", "H", "H", "H", "H", "H", "H", "H", "H", "H", "H", "H", "H", "H", "H", "H", "H", "H", "H", "H"],
        ["H", "T", "A", "H", "H", "H", "H", "H", "H", "H", "H", "H", "H", "H", "H", "H", "H", "H", "H", "H", "H", "H", "H", "H", "H", "H", "H", "H", "H", "H", "H", "H", "H", "H", "H", "H", "H", "H", "H", "H", "H", "H", "H", "H", "H"],
        ["H", "T", "T", "T", "T", "T", "T", "T", "T", "T", "H", "H", "H", "H", "H", "H", "H", "H", "H", "H", "H", "H", "H", "H", "H", "H", "H", "H", "H", "H", "H", "H", "H", "H", "H", "H", "H", "H", "H", "H", "H", "H", "H", "H", "H"],
        ["H", "H", "T", "T", "A", "H", "A", "T", "T", "T", "T", "H", "H", "H", "H", "H", "H", "H", "H", "H", "H", "H", "H", "H", "H", "H", "H", "H", "H", "H", "H", "H", "H", "H", "H", "H", "H", "H", "H", "H", "H", "H", "H", "H", "H"],
        ["A", "A", "H", "H", "A", "A", "H", "H", "H", "T", "T", "H", "H", "H", "H", "H", "H", "H", "H", "H", "H", "H", "H", "H", "H", "H", "H", "H", "H", "H", "H", "H", "H", "H", "H", "H", "H", "H", "H", "H", "H", "H", "H", "H", "H"],
        ["H", "H", "A", "H", "A", "H", "A", "H", "H", "H", "H", "H", "H", "H", "H", "H", "H", "H", "H", "H", "H", "H", "H", "H", "H", "H", "H", "H", "H", "H", "H", "H", "H", "H", "H", "H", "H", "H", "H", "H", "H", "H", "H", "H", "H"],
        ["H", "A", "A", "A", "A", "H", "H", "H", "H", "H", "H", "H", "H", "H", "H", "H", "H", "H", "H", "H", "H", "H", "H", "H", "H", "H", "H", "H", "H", "H", "H", "H", "H", "H", "H", "H", "H", "H", "H", "H", "H", "H", "H", "H", "H"],
        ["H", "H", "H", "H", "H", "A", "H", "H", "E", "E", "E", "H", "H", "H", "H", "H", "H", "H", "H", "H", "H", "H", "H", "H", "H", "H", "H", "H", "H", "H", "H", "H", "H", "H", "H", "H", "H", "H", "H", "H", "H", "H", "H", "H", "H"],
        ["H", "H", "H", "A", "H", "H", "H", "H", "E", "E", "E", "E", "E", "H", "H", "H", "H", "H", "H", "H", "H", "H", "H", "H", "H", "H", "H", "H", "H", "H", "H", "H", "H", "H", "H", "H", "H", "H", "H", "H", "H", "H", "H", "H", "H"],
        ["H", "H", "H", "H", "H", "H", "H", "H", "H", "E", "E", "E", "E", "H", "H", "A", "A", "H", "H", "H", "H", "H", "H", "H", "H", "H", "H", "H", "H", "H", "H", "H", "H", "H", "H", "H", "H", "H", "H", "H", "H", "H", "H", "H", "H"],
        ["H", "H", "H", "A", "H", "H", "H", "H", "H", "E", "E", "E", "E", "E", "A", "H", "H", "A", "H", "H", "H", "H", "H", "H", "H", "H", "H", "H", "H", "H", "H", "H", "H", "H", "H", "H", "H", "H", "H", "H", "H", "H", "H", "H", "H"],
        ["H", "A", "A", "A", "H", "H", "H", "H", "A", "E", "E", "H", "E", "E", "H", "H", "A", "A", "H", "H", "H", "H", "H", "H", "H", "H", "H", "H", "H", "H", "H", "H", "H", "H", "H", "H", "H", "H", "H", "H", "H", "H", "H", "H", "H"],
        ["H", "A", "H", "H", "H", "H", "H", "H", "A", "E", "E", "H", "H", "H", "H", "H", "H", "H", "H", "H", "H", "H", "H", "H", "H", "H", "H", "H", "H", "H", "H", "H", "H", "H", "H", "H", "H", "H", "H", "H", "H", "H", "H", "H", "H"],
        ["H", "H", "H", "E", "E", "E", "H", "H", "E", "E", "E", "H", "H", "H", "H", "H", "H", "H", "H", "H", "H", "H", "H", "H", "H", "H", "H", "H", "H", "H", "H", "H", "H", "H", "H", "H", "H", "H", "H", "H", "H", "H", "H", "H", "H"],
        ["H", "H", "E", "E", "E", "E", "E", "E", "E", "E", "H", "H", "H", "A", "H", "H", "H", "H", "H", "H", "H", "H", "H", "H", "H", "H", "H", "H", "H", "H", "H", "H", "H", "H", "H", "H", "H", "H", "H", "H", "H", "H", "H", "H", "H"],
        ["H", "E", "E", "E", "E", "E", "E", "E", "E", "H", "H", "H", "A", "A", "H", "H", "H", "H", "H", "H", "H", "H", "H", "H", "H", "H", "H", "H", "H", "H", "H", "H", "H", "H", "H", "H", "H", "H", "H", "H", "H", "H", "H", "H", "H"],
        ["H", "E", "E", "E", "E", "E", "E", "E", "H", "H", "H", "H", "H", "H", "H", "H", "H", "H", "H", "H", "H", "H", "H", "H", "H", "H", "H", "H", "H", "H", "H", "H", "H", "H", "H", "H", "H", "H", "H", "H", "H", "H", "H", "H", "H"],
        ["H", "E", "E", "E", "E", "E", "E", "E", "H", "A", "H", "H", "H", "H", "H", "H", "H", "H", "H", "H", "H", "H", "H", "H", "H", "H", "H", "H", "H", "H", "H", "H", "H", "H", "H", "H", "H", "H", "H", "H", "H", "H", "H", "H", "H"],
        ["H", "E", "E", "E", "E", "E", "E", "H", "H", "A", "A", "H", "H", "H", "H", "H", "H", "H", "H", "H", "H", "H", "H", "H", "H", "H", "H", "H", "H", "H", "H", "H", "H", "H", "H", "H", "H", "H", "H", "H", "H", "H", "H", "H", "H"],
        ["H", "A", "E", "E", "E", "E", "H", "H", "H", "H", "A", "H", "H", "H", "H", "H", "H", "H", "H", "H", "H", "H", "H", "H", "H", "H", "H", "H", "H", "H", "H", "H", "H", "H", "H", "H", "H", "H", "H", "H", "H", "H", "H", "H", "H"],
        ["A", "A", "H", "H", "H", "A", "H", "H", "H", "H", "A", "H", "H", "H", "H", "H", "H", "H", "H", "H", "H", "H", "H", "H", "H", "H", "H", "H", "H", "H", "H", "H", "H", "H", "H", "H", "H", "H", "H", "H", "H", "H", "H", "H", "H"],
        ["H", "H", "H", "H", "A", "A", "A", "H", "H", "H", "H", "H", "H", "H", "H", "H", "H", "H", "H", "H", "H", "H", "H", "H", "H", "H", "H", "H", "H", "H", "H", "H", "H", "H", "H", "H", "H", "H", "H", "H", "H", "H", "H", "H", "H"],
        ["H", "H", "H", "H", "H", "A", "H", "H", "H", "H", "H", "H", "H", "H", "H", "H", "H", "H", "H", "H", "H", "H", "H", "H", "H", "H", "H", "H", "H", "H", "H", "H", "H", "H", "H", "H", "H", "H", "H", "H", "H", "H", "H", "H", "H"],
        ["H", "H", "H", "H", "H", "H", "H", "H", "H", "H", "H", "H", "H", "H", "H", "H", "H", "H", "H", "H", "H", "H", "H", "H", "H", "H", "H", "H", "H", "H", "H", "H", "H", "H", "H", "H", "H", "H", "H", "H", "H", "H", "H", "H", "H"],
        ["H", "H", "H", "H", "H", "H", "H", "H", "H", "H", "H", "H", "H", "H", "H", "H", "H", "H", "H", "H", "H", "H", "H", "H", "H", "H", "H", "H", "H", "H", "H", "H", "H", "H", "H", "H", "H", "H", "H", "H", "H", "H", "H", "H", "H"]
      ]
    },
    {
      "__map__":  "Fight map",
      "res": [7, 7],
      "background": "Texture/Background.png",
      "map data": [
        ["A", "H", "H", "H", "H", "H", "R"],
        ["H", "H", "H", "A", "H", "H", "H"],
        ["T", "T", "T", "H", "H", "A", "H"],
        ["T", "H", "T", "T", "H", "H", "H"],
        ["H", "A", "H", "T", "T", "T", "T"],
        ["H", "H", "E", "E", "H", "H", "A"],
        ["R", "R", "E", "E", "H", "H", "H"]
      ]
    },
    {
      "__tile__": "H",
      "texture": "Texture/Herbe 1.png",
      "is walkable": true
    },
    {
      "__tile__": "E",
      "texture": "Texture/Eau 1.png",
      "is walkable": false
    },
    {
      "__tile__": "S",
      "texture": "Texture/Sable 1.png",
      "is walkable": true
    },
    {
      "__tile__": "A",
      "texture": "Texture/Arbre_herbe.png",
      "is walkable": false
    },
    {
      "__tile__": "T",
      "texture": "Texture/Terre.png",
      "is walkable": true
    },
    {
      "__tile__": "R",
      "texture": "Texture/Roche.png",
      "is walkable": false
    }
  ]
}